1111111111111
1C01C00E000C1
1000P11110001
10001100000C1
1111111111111