11111111111111111111111
1C000000000C10C00000001
10000P0000001S000000E01
10111111111010001111111
1000C000C000100000000C1
100C0000000011111100001
100111111111100C0000001
100000000C00000010000C1
11111111111111111111111