1111111111111111111111111111111111111111
1111111111111111111111111111111111111111
11P00001111100000111111E0000000000000011
1100000111110000C11111100000000C00000011
1100000111110000011111100000000000000011
110000C1111100000111111111111110000C0011
1100000111110000011111111111110000000111
1100000111110000011111111111100000001111
1100000000V000C0011111111111000000011111
1100C00000000000011111111110000000111111
110000000000000001111111110H000001111111
1111111111110000011111111000C00011111111
1111111111110000011111110000000111111111
1111111111110000011111100000001111111111
1111111111110C00011111100000000000000C11
11111111111100000111111000C0000000000011
1111111111110000011111100000000000000011
1111111111111111000000001111111111111111
1111111111111111000000C01111111111111111
1111111111111111111111111111111111111111
1111111111111111111111111111111111111111