1111111111111111111111111111111111111111
1P00001111100000111111E00000000000000111
100000111110000C11111100000000C000000111
1000001111100000111111000000000000000111
10000C1111100000111111111111110000C00111
1000001111100000111111111111100000001111
1000001111100000111111111111000000011111
1000000000000C00111111111110000000111111
100C000000000000111111111100000001111111
1000000000000000111111111000000011111111
111111111110000011111111000C000111111111
1111111111100000111111100000001111111111
1111111111100000111111000000011111111111
111111111110C00011111100000000000000C111
1111111111100000111111000C00000000000111
1111111111100000111111000000000000000111
10000000C000000000000000000000C000000111
1011111111111111111111111111111111111111
100000000000000000000C000000000000000111
111111111111111111111111111111111111C111
1111111111111111111111111111111111111111
1111111111111111111111111111111111111111
1111111111111111111111111111111111111111